//MAP CONVERTED BY dmm2tgm.py THIS HEADER COMMENT PREVENTS RECONVERSION, DO NOT REMOVE
"a" = (
/turf/template_noop,
/area/template_noop)
"b" = (
/obj/structure/flora/grass/jungle/b/style_random,
/turf/open/misc/grass/lavaland,
/area/ruin/unpowered/gaia)
"c" = (
/turf/open/misc/grass/lavaland,
/area/ruin/unpowered/gaia)
"d" = (
/obj/structure/flora/grass/jungle/a/style_random,
/turf/open/misc/grass/lavaland,
/area/ruin/unpowered/gaia)
"e" = (
/obj/structure/flora/rock/pile/jungle/style_random,
/turf/open/misc/grass/lavaland,
/area/ruin/unpowered/gaia)
"f" = (
/obj/structure/flora/bush/style_random,
/turf/open/misc/grass/lavaland,
/area/ruin/unpowered/gaia)
"i" = (
/obj/machinery/hydroponics/soil{
	self_sustaining = 1
	},
/turf/open/misc/grass/lavaland,
/area/ruin/unpowered/gaia)
"j" = (
/mob/living/basic/butterfly/lavaland,
/turf/open/misc/grass/lavaland,
/area/ruin/unpowered/gaia)
"k" = (
/obj/item/food/grown/mushroom/amanita,
/turf/open/floor/bronze/filled/lavaland,
/area/ruin/unpowered/gaia)
"l" = (
/obj/item/food/grown/mushroom/angel,
/turf/open/misc/grass/lavaland,
/area/ruin/unpowered/gaia)
"m" = (
/obj/item/food/grown/mushroom/libertycap,
/turf/open/misc/grass/lavaland,
/area/ruin/unpowered/gaia)
"o" = (
/obj/structure/flora/bush/style_random,
/turf/open/floor/bronze/filled/lavaland,
/area/ruin/unpowered/gaia)
"p" = (
/mob/living/basic/lightgeist{
	light_color = "#42ECFF"
	},
/turf/open/misc/grass/lavaland,
/area/ruin/unpowered/gaia)
"q" = (
/obj/structure/flora/tree/jungle/small/style_random,
/turf/open/misc/grass/lavaland,
/area/ruin/unpowered/gaia)
"r" = (
/obj/structure/flora/grass/jungle/b/style_random,
/obj/structure/flora/bush/style_random,
/mob/living/basic/butterfly/lavaland,
/turf/open/misc/grass/lavaland,
/area/ruin/unpowered/gaia)
"s" = (
/obj/item/food/grown/mushroom/amanita,
/turf/open/misc/grass/lavaland,
/area/ruin/unpowered/gaia)
"v" = (
/obj/structure/flora/tree/jungle/style_random,
/turf/open/misc/grass/lavaland,
/area/ruin/unpowered/gaia)
"w" = (
/turf/closed/mineral/volcanic/lava_land_surface,
/area/ruin/unpowered/gaia)
"x" = (
/obj/structure/flora/bush/style_random,
/obj/structure/flora/bush/style_random,
/turf/open/misc/grass/lavaland,
/area/ruin/unpowered/gaia)
"B" = (
/obj/structure/flora/grass/jungle/a/style_random,
/mob/living/basic/lightgeist{
	light_color = "#42ECFF"
	},
/turf/open/misc/grass/lavaland,
/area/ruin/unpowered/gaia)
"D" = (
/obj/item/food/grown/mushroom/chanterelle,
/turf/open/misc/grass/lavaland,
/area/ruin/unpowered/gaia)
"E" = (
/turf/open/floor/bronze/filled/lavaland,
/area/ruin/unpowered/gaia)
"J" = (
/turf/closed/wall/mineral/bronze,
/area/ruin/unpowered/gaia)
"K" = (
/obj/structure/flora/bush/style_random,
/obj/structure/flora/bush/style_random,
/turf/open/floor/bronze/filled/lavaland,
/area/ruin/unpowered/gaia)
"N" = (
/obj/structure/flora/grass/jungle/b/style_random,
/turf/open/floor/bronze/filled/lavaland,
/area/ruin/unpowered/gaia)
"P" = (
/obj/structure/flora/grass/jungle/b/style_random,
/obj/structure/flora/bush/style_random,
/turf/open/misc/grass/lavaland,
/area/ruin/unpowered/gaia)
"T" = (
/obj/structure/flora/grass/jungle/a/style_random,
/turf/open/floor/bronze/filled/lavaland,
/area/ruin/unpowered/gaia)
"V" = (
/obj/item/mod/construction/lavalandcore,
/turf/open/misc/grass/lavaland,
/area/ruin/unpowered/gaia)
"Z" = (
/obj/structure/flora/grass/jungle/b/style_random,
/turf/closed/wall/mineral/bronze,
/area/ruin/unpowered/gaia)

(1,1,1) = {"
a
a
a
a
a
w
w
w
w
w
w
w
a
a
a
a
"}
(2,1,1) = {"
a
a
a
a
w
w
c
N
c
b
c
w
w
a
a
a
"}
(3,1,1) = {"
a
a
a
w
w
c
f
d
f
c
d
c
w
a
a
a
"}
(4,1,1) = {"
a
a
w
w
c
d
c
i
T
f
f
c
w
w
w
a
"}
(5,1,1) = {"
a
a
w
c
c
c
c
p
j
s
b
f
c
b
w
a
"}
(6,1,1) = {"
a
w
w
f
d
c
c
E
v
T
c
c
f
w
w
a
"}
(7,1,1) = {"
w
w
b
c
m
r
c
c
f
f
f
b
f
c
w
w
"}
(8,1,1) = {"
w
b
c
d
c
f
c
N
B
f
d
m
d
f
c
w
"}
(9,1,1) = {"
w
c
d
c
f
d
c
d
f
o
f
j
c
b
f
w
"}
(10,1,1) = {"
w
c
o
f
b
o
c
J
x
Z
T
c
K
b
o
w
"}
(11,1,1) = {"
w
d
e
i
o
d
c
x
V
o
f
o
c
q
c
w
"}
(12,1,1) = {"
w
o
b
c
p
f
k
J
P
J
f
T
f
c
N
w
"}
(13,1,1) = {"
w
b
c
d
q
d
b
c
c
o
c
c
b
D
f
w
"}
(14,1,1) = {"
w
w
f
c
f
c
c
b
o
b
j
f
i
f
d
w
"}
(15,1,1) = {"
a
w
w
l
j
c
f
o
c
f
c
j
c
c
w
w
"}
(16,1,1) = {"
a
a
w
c
b
c
c
f
c
o
c
f
c
w
w
a
"}
(17,1,1) = {"
a
a
w
d
f
c
p
f
f
f
e
c
f
w
a
a
"}
(18,1,1) = {"
a
a
w
w
c
b
f
c
o
j
f
c
c
w
a
a
"}
(19,1,1) = {"
a
a
a
w
w
c
f
c
f
c
c
w
w
w
a
a
"}
(20,1,1) = {"
a
a
a
a
w
w
w
w
w
w
w
w
a
a
a
a
"}
