//MAP CONVERTED BY dmm2tgm.py THIS HEADER COMMENT PREVENTS RECONVERSION, DO NOT REMOVE
"a" = (
/turf/closed/indestructible/binary,
/area/virtual_domain/fullbright)
"c" = (
/turf/open/space/basic,
/area/space/virtual_domain)
"e" = (
/obj/effect/baseturf_helper/virtual_domain,
/turf/closed/mineral/random,
/area/virtual_domain)
"g" = (
/obj/structure/marker_beacon{
	light_color = "#FFE8AA";
	light_range = 20
	},
/turf/open/floor/grass,
/area/virtual_domain)
"h" = (
/turf/closed/mineral/random,
/area/virtual_domain)
"m" = (
/obj/structure/closet/crate/secure/bitrunning/encrypted/gondola,
/turf/open/floor/grass,
/area/virtual_domain)
"n" = (
/obj/structure/flora/bush/style_random,
/turf/open/floor/grass,
/area/virtual_domain)
"o" = (
/turf/template_noop,
/area/template_noop)
"q" = (
/obj/structure/flora/tree/palm,
/turf/open/floor/grass,
/area/virtual_domain)
"r" = (
/obj/effect/baseturf_helper/virtual_domain,
/turf/template_noop,
/area/virtual_domain/safehouse)
"t" = (
/turf/template_noop,
/area/virtual_domain/safehouse)
"v" = (
/turf/open/misc/asteroid/airless,
/area/virtual_domain)
"w" = (
/obj/structure/water_source/puddle,
/turf/open/floor/grass,
/area/virtual_domain)
"z" = (
/mob/living/basic/pet/gondola/virtual_domain,
/turf/open/floor/grass,
/area/virtual_domain)
"A" = (
/obj/structure/chair/wood{
	dir = 8
	},
/turf/template_noop,
/area/virtual_domain/safehouse)
"C" = (
/turf/open/floor/grass,
/area/virtual_domain)
"M" = (
/obj/structure/table/wood,
/obj/item/storage/bag/tray,
/obj/item/kitchen/fork,
/obj/item/knife/kitchen,
/turf/template_noop,
/area/virtual_domain/safehouse)
"O" = (
/obj/modular_map_root/safehouse{
	key = "shuttle_space"
	},
/turf/template_noop,
/area/virtual_domain/safehouse)
"V" = (
/obj/structure/flora/coconuts,
/turf/open/floor/grass,
/area/virtual_domain)

(1,1,1) = {"
o
o
o
o
o
o
o
o
o
o
o
o
o
o
o
o
o
o
o
o
o
o
o
o
o
a
a
a
a
a
a
a
a
o
o
o
o
o
o
o
o
o
o
"}
(2,1,1) = {"
o
o
o
o
o
o
o
o
o
o
o
o
o
o
o
o
o
o
o
o
o
o
o
a
a
a
h
h
h
h
h
h
a
a
o
o
o
o
o
o
o
o
o
"}
(3,1,1) = {"
o
o
o
o
o
o
o
o
o
o
o
o
o
o
o
o
o
o
o
a
a
a
a
a
h
h
h
h
h
h
h
h
h
a
a
a
o
o
o
o
o
o
o
"}
(4,1,1) = {"
o
o
o
o
o
o
o
o
o
o
o
o
o
o
a
a
a
a
a
a
a
h
h
h
h
h
h
h
h
h
h
h
h
h
e
a
o
o
o
o
o
o
o
"}
(5,1,1) = {"
o
o
o
o
o
o
o
o
o
o
o
o
o
a
a
h
h
h
h
h
h
h
h
h
h
h
h
h
h
C
h
h
h
h
h
a
o
o
o
o
o
o
o
"}
(6,1,1) = {"
o
o
o
o
o
o
o
o
a
a
a
a
a
a
h
h
h
h
h
h
h
h
h
h
h
C
C
C
C
C
C
C
h
h
h
a
o
o
o
o
o
o
o
"}
(7,1,1) = {"
o
o
o
o
o
o
o
a
a
h
h
h
h
h
h
h
h
h
h
h
h
h
h
C
C
C
C
n
C
C
C
z
C
h
h
a
o
o
o
o
o
o
o
"}
(8,1,1) = {"
o
o
o
o
o
a
a
a
h
h
h
h
h
h
h
h
h
h
h
h
h
C
C
C
C
n
C
q
C
h
h
h
h
h
v
a
a
a
a
a
a
a
a
"}
(9,1,1) = {"
o
o
o
o
a
a
h
h
h
h
h
h
h
h
h
h
C
h
C
C
C
C
C
C
C
C
V
C
C
C
C
h
h
h
v
c
c
c
c
c
c
c
a
"}
(10,1,1) = {"
o
o
a
a
a
h
h
h
h
h
h
h
h
C
q
C
C
n
C
C
V
C
C
q
C
C
C
C
n
C
C
h
h
h
v
c
c
c
c
c
c
c
a
"}
(11,1,1) = {"
o
a
a
h
h
h
h
h
h
h
h
h
h
h
h
C
C
C
C
C
n
C
C
C
C
C
C
n
C
C
C
h
h
h
v
c
c
c
c
c
c
c
a
"}
(12,1,1) = {"
o
a
h
h
h
h
h
h
h
h
h
h
h
h
C
n
n
n
C
C
g
C
C
V
C
z
C
n
C
g
C
h
h
h
v
c
c
c
c
c
c
c
a
"}
(13,1,1) = {"
a
a
h
h
h
h
h
h
h
h
h
h
C
C
C
C
n
n
C
z
C
C
C
C
C
C
C
n
n
C
C
h
h
h
v
c
c
c
c
c
c
c
a
"}
(14,1,1) = {"
a
h
h
h
h
h
h
h
h
h
h
h
C
C
w
C
n
C
n
C
C
C
C
C
C
n
C
C
C
C
h
h
h
h
v
c
c
c
c
c
c
c
a
"}
(15,1,1) = {"
a
h
h
h
h
h
h
h
h
h
h
z
C
C
C
C
n
C
C
C
n
n
C
C
C
C
C
w
C
h
h
h
h
h
v
c
c
c
c
c
c
c
a
"}
(16,1,1) = {"
a
h
h
h
h
h
h
h
h
h
h
h
h
h
h
C
C
C
C
C
n
n
C
C
C
C
C
C
C
C
h
h
h
h
v
c
c
c
c
c
c
c
a
"}
(17,1,1) = {"
a
h
h
h
h
h
h
h
h
h
h
h
h
h
h
h
h
C
C
C
n
n
C
C
C
C
q
C
C
C
C
h
h
h
h
t
t
t
t
t
O
c
a
"}
(18,1,1) = {"
a
h
h
h
h
h
h
h
h
h
h
h
h
h
h
h
h
h
C
n
n
C
C
C
C
C
C
C
C
C
C
C
h
h
h
t
t
M
M
t
t
c
a
"}
(19,1,1) = {"
a
h
h
h
h
h
h
h
h
h
C
n
C
h
h
h
h
h
C
C
C
C
C
C
n
n
C
C
C
n
C
C
h
C
C
t
t
A
A
t
t
c
a
"}
(20,1,1) = {"
a
h
h
h
h
h
h
h
h
C
C
C
C
C
C
h
h
h
C
C
q
V
C
C
C
n
C
C
C
C
C
C
C
C
C
t
t
t
t
t
t
c
a
"}
(21,1,1) = {"
a
v
h
h
h
h
h
h
h
z
C
C
g
C
C
C
C
C
C
C
C
C
C
C
C
C
C
C
C
C
C
C
C
C
C
t
t
t
t
t
t
c
a
"}
(22,1,1) = {"
a
v
v
h
h
h
h
h
h
C
C
C
q
C
n
n
C
C
n
C
m
C
C
C
g
C
z
C
C
C
C
C
h
h
h
t
t
t
t
t
t
c
a
"}
(23,1,1) = {"
a
v
v
h
h
h
h
h
h
C
C
C
C
C
C
n
C
C
C
C
C
C
C
C
C
C
C
C
C
q
C
C
h
h
h
t
t
t
t
t
r
c
a
"}
(24,1,1) = {"
a
v
v
h
h
h
h
h
h
C
C
V
C
C
C
C
C
C
C
w
C
z
n
C
C
C
n
C
C
C
C
C
h
h
h
c
c
c
c
c
c
c
a
"}
(25,1,1) = {"
a
a
v
v
h
h
h
h
n
C
C
C
C
C
z
C
C
C
C
C
C
C
C
C
n
C
C
C
C
C
C
C
h
h
h
c
c
c
c
c
c
c
a
"}
(26,1,1) = {"
o
a
v
v
h
h
h
C
C
C
C
C
C
C
C
C
n
n
C
C
C
C
C
C
n
n
C
C
C
C
C
h
h
h
c
c
c
c
c
c
c
c
a
"}
(27,1,1) = {"
o
a
v
v
h
h
h
C
C
C
w
C
C
C
C
n
n
n
C
n
C
C
C
C
C
C
q
C
C
V
C
h
h
h
c
c
c
c
c
c
c
c
a
"}
(28,1,1) = {"
o
a
v
v
h
h
h
h
C
C
C
C
C
C
C
C
C
C
C
g
n
n
C
C
C
C
C
C
C
C
h
h
h
c
c
c
c
c
c
c
c
c
a
"}
(29,1,1) = {"
o
a
a
v
v
h
h
h
C
C
C
C
C
n
C
C
C
C
C
C
n
n
n
C
C
C
C
w
C
h
h
h
h
c
c
c
c
c
c
c
c
c
a
"}
(30,1,1) = {"
o
o
a
v
v
h
h
C
C
C
n
C
C
C
C
C
C
C
C
C
C
C
C
C
C
n
C
C
C
h
h
h
v
v
c
c
c
c
c
c
c
c
a
"}
(31,1,1) = {"
o
o
a
v
h
h
C
g
n
C
n
C
C
C
h
C
C
C
C
C
V
C
C
C
C
C
C
C
h
h
h
v
v
v
c
c
c
c
c
c
c
c
a
"}
(32,1,1) = {"
o
o
a
h
h
h
h
C
C
C
C
C
C
h
h
h
C
C
C
q
C
C
C
C
C
C
h
h
h
h
v
v
v
h
h
a
a
a
a
a
a
a
a
"}
(33,1,1) = {"
o
o
a
h
h
h
C
C
C
C
C
C
h
h
h
h
h
h
h
h
h
h
h
h
h
h
h
h
h
h
v
v
h
h
h
a
o
o
o
o
o
o
o
"}
(34,1,1) = {"
o
o
a
h
h
C
C
C
C
h
h
h
h
h
h
h
h
h
h
h
h
h
h
h
h
h
h
h
h
a
a
h
h
h
a
a
o
o
o
o
o
o
o
"}
(35,1,1) = {"
o
o
a
h
h
h
h
h
h
h
h
h
h
h
v
v
v
v
v
h
h
h
h
h
a
a
a
a
a
a
a
h
h
h
a
a
o
o
o
o
o
o
o
"}
(36,1,1) = {"
o
o
a
a
h
h
h
h
h
h
h
h
h
a
a
a
a
a
a
a
a
a
a
a
a
o
o
o
o
o
a
a
a
a
a
o
o
o
o
o
o
o
o
"}
(37,1,1) = {"
o
o
o
a
a
a
a
a
a
a
a
a
a
a
o
o
o
o
o
o
o
o
o
o
o
o
o
o
o
o
o
o
o
o
o
o
o
o
o
o
o
o
o
"}
