//MAP CONVERTED BY dmm2tgm.py THIS HEADER COMMENT PREVENTS RECONVERSION, DO NOT REMOVE
"a" = (
/turf/template_noop,
/area/template_noop)
"b" = (
/turf/closed/mineral/random,
/area/ruin/space/has_grav)
"c" = (
/turf/open/misc/asteroid/airless,
/area/ruin/space/has_grav)
"d" = (
/turf/open/floor/grass,
/area/ruin/space/has_grav)
"e" = (
/obj/structure/marker_beacon{
	light_color = "#FFE8AA";
	light_range = 20
	},
/turf/open/floor/grass,
/area/ruin/space/has_grav)
"f" = (
/obj/structure/flora/bush/style_random,
/turf/open/floor/grass,
/area/ruin/space/has_grav)
"h" = (
/mob/living/basic/pet/gondola,
/turf/open/floor/grass,
/area/ruin/space/has_grav)
"j" = (
/obj/structure/flora/coconuts,
/turf/open/floor/grass,
/area/ruin/space/has_grav)
"r" = (
/obj/structure/flora/tree/palm,
/turf/open/floor/grass,
/area/ruin/space/has_grav)
"u" = (
/obj/structure/water_source/puddle,
/turf/open/floor/grass,
/area/ruin/space/has_grav)
"v" = (
/obj/machinery/door/airlock/survival_pod/glass{
	dir = 4
	},
/obj/effect/mapping_helpers/airlock/cyclelink_helper,
/turf/open/floor/grass,
/area/ruin/space/has_grav)
"w" = (
/obj/machinery/door/airlock/survival_pod/glass{
	dir = 4
	},
/obj/effect/mapping_helpers/airlock/cyclelink_helper{
	dir = 1
	},
/turf/open/floor/grass,
/area/ruin/space/has_grav)

(1,1,1) = {"
a
a
a
a
a
a
a
a
a
a
a
a
a
a
a
a
a
a
a
a
a
a
a
a
a
a
b
b
b
b
b
b
a
a
a
"}
(2,1,1) = {"
a
a
a
a
b
b
a
a
a
a
a
a
a
a
a
a
a
a
a
a
a
a
a
a
b
b
b
b
b
b
b
b
b
a
a
"}
(3,1,1) = {"
a
a
b
b
b
b
b
a
a
a
a
a
a
a
a
a
a
a
a
b
b
b
b
b
b
b
b
b
b
b
b
b
b
b
c
"}
(4,1,1) = {"
a
b
b
b
b
a
a
a
a
a
a
a
a
a
a
b
b
b
b
b
b
b
b
b
b
b
b
b
b
d
b
b
b
b
b
"}
(5,1,1) = {"
a
b
b
b
a
a
a
a
a
a
a
a
a
a
b
b
b
b
b
b
b
b
b
b
b
d
d
d
d
d
d
d
b
b
b
"}
(6,1,1) = {"
a
a
a
a
a
a
a
a
a
b
b
b
b
b
b
b
b
b
b
b
b
b
b
d
d
d
d
f
d
d
d
h
d
b
b
"}
(7,1,1) = {"
a
a
a
a
a
a
a
a
b
b
b
b
b
b
b
b
b
b
b
b
b
d
d
d
d
f
d
r
d
b
b
b
b
b
c
"}
(8,1,1) = {"
a
a
a
a
a
a
b
b
b
b
b
b
b
b
b
b
d
b
d
d
d
d
d
d
d
d
j
d
d
d
d
b
b
b
c
"}
(9,1,1) = {"
a
a
a
a
a
b
b
b
b
b
b
b
b
d
r
d
d
f
d
d
j
d
d
r
d
d
d
d
f
d
d
b
b
b
c
"}
(10,1,1) = {"
a
a
a
b
b
b
b
b
b
b
b
b
b
b
b
d
d
d
d
d
f
d
d
d
d
d
d
f
d
d
d
b
b
b
c
"}
(11,1,1) = {"
a
a
b
b
b
b
b
b
b
b
b
b
b
b
d
f
f
f
d
d
e
d
d
j
d
h
d
f
d
e
d
b
b
b
c
"}
(12,1,1) = {"
a
a
b
b
b
b
b
b
b
b
b
b
d
d
d
d
f
f
d
h
d
d
d
d
d
d
d
f
f
d
d
b
b
b
c
"}
(13,1,1) = {"
a
b
b
b
b
b
b
b
b
b
b
b
d
d
u
d
f
d
f
d
d
d
d
d
d
f
d
d
d
d
b
b
b
b
c
"}
(14,1,1) = {"
a
b
b
b
b
b
b
b
b
b
b
h
d
d
d
d
f
d
d
d
f
f
d
d
d
d
d
u
d
b
b
b
b
b
c
"}
(15,1,1) = {"
a
b
b
b
b
b
b
b
b
b
b
b
b
b
b
d
d
d
d
d
f
f
d
d
d
d
d
d
d
d
b
b
b
b
c
"}
(16,1,1) = {"
a
b
b
b
b
b
b
b
b
b
b
b
b
b
b
b
b
d
d
d
f
f
d
d
d
d
r
d
d
d
d
b
b
b
c
"}
(17,1,1) = {"
a
b
b
b
b
b
b
b
b
b
b
b
b
b
b
b
b
b
d
f
f
d
d
d
d
d
d
d
d
d
d
d
b
b
c
"}
(18,1,1) = {"
a
b
b
b
b
b
b
b
b
b
d
f
d
b
b
b
b
b
d
d
d
d
d
d
f
f
d
d
d
f
d
d
b
b
b
"}
(19,1,1) = {"
a
b
b
b
b
b
b
b
b
d
d
d
d
d
d
b
b
b
d
d
r
j
d
d
d
f
d
d
d
d
d
d
v
d
w
"}
(20,1,1) = {"
a
c
b
b
b
b
b
b
b
h
d
d
e
d
d
d
d
d
d
d
d
d
d
d
d
d
d
d
d
d
d
b
b
b
b
"}
(21,1,1) = {"
a
c
c
b
b
b
b
b
b
d
d
d
r
d
f
f
d
d
f
d
d
d
d
d
e
d
h
d
d
d
d
d
b
b
b
"}
(22,1,1) = {"
a
c
c
b
b
b
b
b
b
d
d
d
d
d
d
f
d
d
d
d
d
d
d
d
d
d
d
d
d
r
d
d
b
b
b
"}
(23,1,1) = {"
a
c
c
b
b
b
b
b
b
d
d
j
d
d
d
d
d
d
d
u
d
h
f
d
d
d
f
d
d
d
d
d
b
b
b
"}
(24,1,1) = {"
a
a
c
c
b
b
b
b
f
d
d
d
d
d
h
d
d
d
d
d
d
d
d
d
f
d
d
d
d
d
d
d
b
b
b
"}
(25,1,1) = {"
a
a
c
c
b
b
b
d
d
d
d
d
d
d
d
d
f
f
d
d
d
d
d
d
f
f
d
d
d
d
d
b
b
b
a
"}
(26,1,1) = {"
a
a
c
c
b
b
b
d
d
d
u
d
d
d
d
f
f
f
d
f
d
d
d
d
d
d
r
d
d
j
d
b
b
b
a
"}
(27,1,1) = {"
a
a
c
c
b
b
b
b
d
d
d
d
d
d
d
d
d
d
d
e
f
f
d
d
d
d
d
d
d
d
b
b
b
a
a
"}
(28,1,1) = {"
a
a
a
c
c
b
b
b
d
d
d
d
d
f
d
d
d
d
d
d
f
f
f
d
d
d
d
u
d
b
b
b
b
a
a
"}
(29,1,1) = {"
a
a
a
c
c
b
b
d
d
d
f
d
d
d
d
d
d
d
d
d
d
d
d
d
d
f
d
d
d
b
b
b
c
c
a
"}
(30,1,1) = {"
a
a
a
c
b
b
d
e
f
d
f
d
d
d
b
d
d
d
d
d
j
d
d
d
d
d
d
d
b
b
b
c
c
c
a
"}
(31,1,1) = {"
a
a
a
b
b
b
b
d
d
d
d
d
d
b
b
b
d
d
d
r
d
d
d
d
d
d
b
b
b
b
c
c
c
b
b
"}
(32,1,1) = {"
a
a
a
b
b
b
d
d
d
d
d
d
b
b
b
b
b
b
b
b
b
b
b
b
b
b
b
b
b
b
c
c
b
b
b
"}
(33,1,1) = {"
a
a
a
b
b
d
d
d
d
b
b
b
b
b
b
b
b
b
b
b
b
b
b
b
b
b
b
b
b
a
a
b
b
b
a
"}
(34,1,1) = {"
a
a
a
b
b
b
b
b
b
b
b
b
b
b
c
c
c
c
c
b
b
b
b
b
a
a
a
a
a
a
a
b
b
b
a
"}
(35,1,1) = {"
a
a
a
a
b
b
b
b
b
b
b
b
b
a
a
a
a
a
a
a
a
a
a
a
a
a
a
a
a
a
a
a
a
a
a
"}
