//MAP CONVERTED BY dmm2tgm.py THIS HEADER COMMENT PREVENTS RECONVERSION, DO NOT REMOVE
"a" = (
/obj/structure/flora/bush/style_random,
/turf/open/floor/holofloor/grass,
/area/template_noop)
"c" = (
/obj/machinery/hydroponics/soil,
/turf/open/floor/holofloor/grass,
/area/template_noop)
"g" = (
/obj/effect/holodeck_effect/mobspawner/pet,
/turf/open/floor/holofloor/grass,
/area/template_noop)
"k" = (
/obj/structure/flora/tree/jungle/small/style_random,
/turf/open/floor/holofloor/grass,
/area/template_noop)
"p" = (
/obj/structure/flora/bush/style_random,
/obj/effect/holodeck_effect/mobspawner/pet,
/turf/open/floor/holofloor/grass,
/area/template_noop)
"q" = (
/obj/machinery/hydroponics/soil,
/obj/effect/holodeck_effect/mobspawner/pet,
/turf/open/floor/holofloor/grass,
/area/template_noop)
"w" = (
/obj/effect/holodeck_effect/mobspawner/pet,
/obj/structure/flora/bush/style_random,
/turf/open/floor/holofloor/grass,
/area/template_noop)
"I" = (
/turf/open/floor/holofloor/grass,
/area/template_noop)
"N" = (
/obj/effect/turf_decal/tile/red/opposingcorners,
/obj/effect/turf_decal/tile/blue/opposingcorners{
	dir = 1
	},
/turf/open/floor/holofloor,
/area/template_noop)
"S" = (
/obj/item/plate,
/obj/effect/turf_decal/tile/red/opposingcorners,
/obj/effect/turf_decal/tile/blue/opposingcorners{
	dir = 1
	},
/turf/open/floor/holofloor,
/area/template_noop)
"U" = (
/obj/machinery/hydroponics/soil,
/obj/item/cultivator,
/turf/open/floor/holofloor/grass,
/area/template_noop)
"V" = (
/obj/item/shovel/spade{
	pixel_x = 2;
	pixel_y = -2
	},
/obj/effect/turf_decal/tile/red/opposingcorners,
/obj/effect/turf_decal/tile/blue/opposingcorners{
	dir = 1
	},
/turf/open/floor/holofloor,
/area/template_noop)
"X" = (
/obj/item/reagent_containers/cup/watering_can,
/turf/open/floor/holofloor/grass,
/area/template_noop)
"Z" = (
/obj/effect/holodeck_effect/mobspawner/pet,
/obj/effect/turf_decal/tile/red/opposingcorners,
/obj/effect/turf_decal/tile/blue/opposingcorners{
	dir = 1
	},
/turf/open/floor/holofloor,
/area/template_noop)

(1,1,1) = {"
g
I
I
I
a
I
I
a
I
a
"}
(2,1,1) = {"
I
a
I
a
g
I
a
w
a
I
"}
(3,1,1) = {"
a
g
a
I
k
a
I
c
c
I
"}
(4,1,1) = {"
I
a
a
I
I
a
a
U
q
I
"}
(5,1,1) = {"
a
w
N
Z
a
a
X
q
c
a
"}
(6,1,1) = {"
I
I
S
V
I
p
I
c
c
I
"}
(7,1,1) = {"
I
a
g
a
I
a
a
I
I
a
"}
(8,1,1) = {"
a
a
a
I
I
I
g
I
a
I
"}
(9,1,1) = {"
I
I
I
I
I
a
I
I
I
I
"}
